This	DT
is	VBZ
a	DT
sample	NN
text	NN
file	NN
.	.
This	DT
file	NN
has	VBZ
multiple	JJ
sentences	NNS
and	CC
multiple	JJ
lines	NNS
.	.
This	DT
project	NN
is	VBZ
built	VBN
using	VBG
the	DT
Eclipse	NNP
4	CD
RCP	NNP
framework	NN
.	.